11111111111111111111
11E00000010C00000001
110C000000C000C00011
1P1C00C00E0000000011
1010C000000100000001
1010C000C001000C0001
1000C000000100000001
1000C000C0000C000001
1000C00000C0000C0011
11111111111111111111
